77, 77, 77, 77, 77, 77, 77, 77, 77, 77, 77, 77, 77, 77, 77, 77, 77, 77, 77, 77, 77, 77, 77, 77, 77, 77, 77, 77, 77, 77, 77, 77, 77, 77, 77, 77, 77, 77, 77, 77, 77, 77, 77, 77, 77, 77, 77, 77, 77, 77,
77, 39, 39, 39, 39, 39, 39, 39, 39, 39, 39, 39, 39, 195, 39, 39, 39, 39, 195, 39, 39, 195, 39, 39, 39, 39, 39, 39, 39, 39, 195, 39, 39, 195, 39, 39, 39, 39, 39, 39, 39, 39, 39, 39, 39, 39, 39, 39, 39, 77,
77, 39, 257, 39, 39, 268, 39, 39, 39, 39, 257, 39, 39, 39, 39, 39, 268, 39, 39, 39, 39, 39, 39, 39, 195, 39, 39, 195, 39, 39, 39, 257, 39, 39, 39, 39, 195, 39, 39, 39, 39, 39, 39, 39, 39, 39, 39, 39, 39, 77,
77, 39, 39, 39, 39, 39, 39, 39, 257, 39, 39, 39, 39, 39, 39, 39, 39, 39, 39, 39, 39, 39, 39, 39, 39, 39, 39, 39, 39, 39, 39, 39, 39, 39, 268, 39, 39, 39, 39, 39, 39, 39, 39, 39, 39, 39, 39, 39, 39, 77,
77, 39, 39, 39, 39, 39, 39, 39, 39, 39, 39, 268, 39, 39, 39, 39, 39, 39, 39, 39, 39, 39, 39, 39, 39, 39, 257, 39, 39, 39, 39, 257, 39, 39, 257, 39, 39, 39, 39, 39, 39, 39, 39, 39, 39, 39, 39, 39, 39, 77,
77, 39, 39, 39, 257, 39, 39, 39, 39, 39, 39, 39, 39, 39, 39, 39, 39, 39, 39, 39, 39, 39, 39, 39, 39, 39, 268, 39, 39, 39, 39, 39, 39, 39, 39, 39, 39, 39, 39, 39, 39, 39, 39, 39, 39, 39, 39, 39, 39, 77,
77, 39, 39, 39, 39, 39, 257, 39, 39, 39, 39, 268, 39, 39, 39, 39, 39, 268, 39, 39, 39, 39, 268, 39, 39, 39, 39, 39, 257, 39, 39, 39, 39, 39, 39, 257, 39, 39, 39, 39, 39, 39, 39, 39, 39, 39, 39, 39, 39, 77,
77, 39, 39, 268, 39, 39, 39, 39, 39, 39, 39, 39, 39, 39, 39, 39, 39, 39, 39, 39, 39, 39, 39, 39, 39, 39, 39, 39, 39, 39, 39, 39, 39, 39, 39, 39, 39, 39, 39, 39, 39, 39, 39, 39, 39, 39, 39, 39, 39, 77,
77, 39, 39, 39, 39, 39, 39, 39, 257, 39, 39, 39, 39, 39, 39, 39, 39, 39, 39, 39, 39, 39, 39, 39, 39, 39, 39, 39, 39, 39, 39, 39, 39, 39, 39, 39, 39, 39, 39, 39, 39, 39, 39, 39, 39, 39, 39, 39, 39, 77,
77, 39, 39, 39, 39, 39, 39, 268, 39, 39, 39, 257, 39, 39, 111, 112, 39, 39, 39, 39, 39, 39, 39, 39, 39, 39, 39, 39, 39, 39, 39, 39, 39, 39, 39, 39, 39, 39, 39, 39, 39, 39, 39, 39, 39, 39, 39, 39, 39, 77,
77, 39, 39, 39, 257, 39, 39, 39, 39, 39, 39, 39, 39, 39, 39, 39, 39, 39, 39, 39, 39, 39, 39, 39, 39, 39, 39, 39, 39, 39, 39, 39, 39, 39, 39, 39, 39, 39, 39, 39, 39, 39, 39, 39, 39, 39, 39, 39, 39, 77,
77, 39, 39, 39, 39, 39, 39, 39, 39, 39, 257, 39, 39, 39, 39, 39, 39, 39, 39, 39, 39, 39, 39, 39, 39, 39, 39, 39, 39, 39, 39, 39, 39, 39, 39, 39, 39, 39, 39, 39, 39, 39, 39, 39, 39, 39, 39, 39, 39, 77,
77, 39, 39, 39, 39, 39, 39, 39, 39, 39, 39, 39, 39, 39, 39, 39, 39, 39, 39, 39, 268, 39, 39, 39, 39, 39, 39, 39, 39, 39, 39, 39, 39, 39, 39, 39, 39, 39, 39, 39, 39, 39, 39, 39, 39, 39, 39, 39, 39, 77,
77, 39, 39, 39, 39, 268, 39, 39, 39, 39, 39, 39, 39, 257, 39, 39, 39, 39, 39, 39, 39, 39, 39, 39, 39, 39, 39, 39, 39, 39, 39, 39, 39, 39, 39, 39, 39, 39, 39, 39, 39, 39, 39, 39, 39, 39, 39, 39, 39, 77,
77, 39, 39, 39, 39, 39, 39, 39, 39, 39, 268, 39, 39, 39, 39, 39, 39, 39, 39, 39, 39, 39, 39, 39, 39, 39, 39, 39, 39, 39, 39, 39, 39, 39, 39, 39, 268, 39, 39, 39, 39, 39, 39, 39, 39, 39, 39, 39, 39, 77,
77, 39, 39, 39, 39, 39, 39, 39, 39, 39, 39, 39, 39, 39, 39, 39, 268, 39, 39, 39, 39, 39, 39, 39, 39, 39, 39, 39, 39, 39, 39, 39, 39, 39, 39, 39, 39, 39, 39, 39, 39, 39, 39, 39, 39, 39, 39, 39, 39, 77,
77, 39, 39, 39, 39, 39, 39, 39, 39, 39, 39, 39, 39, 39, 257, 39, 39, 39, 39, 39, 39, 268, 39, 39, 39, 39, 39, 39, 39, 39, 39, 39, 39, 39, 39, 39, 39, 39, 39, 39, 39, 39, 39, 39, 39, 39, 39, 39, 39, 77,
77, 39, 39, 39, 39, 39, 39, 39, 39, 39, 39, 39, 39, 39, 39, 39, 39, 39, 39, 39, 39, 39, 257, 39, 39, 39, 39, 257, 39, 39, 39, 39, 268, 39, 39, 39, 39, 39, 39, 39, 39, 39, 39, 39, 39, 39, 39, 39, 39, 77,
77, 39, 39, 268, 39, 39, 39, 39, 39, 39, 39, 39, 39, 39, 39, 39, 257, 39, 268, 39, 39, 39, 39, 39, 39, 39, 39, 39, 39, 39, 39, 39, 39, 39, 39, 39, 39, 39, 39, 39, 39, 268, 39, 39, 39, 39, 39, 39, 39, 77,
77, 39, 39, 39, 39, 39, 39, 268, 39, 39, 39, 39, 39, 39, 39, 39, 39, 39, 39, 39, 39, 39, 39, 39, 39, 39, 39, 39, 39, 39, 39, 39, 257, 39, 39, 257, 39, 39, 39, 39, 39, 39, 39, 39, 39, 39, 39, 39, 39, 77,
77, 39, 39, 39, 39, 39, 39, 39, 39, 39, 39, 268, 39, 39, 39, 39, 39, 39, 39, 39, 39, 39, 257, 39, 39, 39, 39, 39, 39, 39, 39, 39, 39, 39, 39, 39, 39, 39, 39, 39, 39, 39, 39, 39, 39, 39, 39, 39, 39, 77,
77, 39, 39, 39, 39, 39, 39, 39, 39, 39, 39, 39, 39, 39, 39, 39, 257, 39, 39, 39, 39, 39, 39, 39, 39, 39, 268, 39, 39, 39, 39, 39, 39, 39, 39, 39, 39, 39, 39, 39, 39, 39, 39, 39, 261, 39, 39, 39, 39, 77,
77, 39, 39, 39, 268, 39, 39, 39, 39, 39, 39, 39, 39, 39, 39, 39, 39, 39, 39, 39, 39, 39, 39, 39, 39, 39, 39, 257, 39, 268, 39, 39, 39, 39, 257, 39, 257, 39, 39, 39, 39, 39, 39, 39, 39, 39, 39, 39, 39, 77,
77, 39, 39, 39, 39, 39, 39, 39, 257, 39, 39, 39, 39, 39, 39, 39, 257, 39, 39, 39, 39, 39, 39, 39, 39, 39, 257, 39, 39, 39, 39, 39, 39, 39, 39, 39, 39, 39, 39, 39, 39, 39, 39, 39, 39, 39, 39, 39, 39, 77,
77, 39, 39, 39, 39, 39, 39, 39, 39, 39, 39, 268, 39, 39, 39, 39, 39, 39, 39, 39, 39, 39, 39, 39, 39, 39, 39, 39, 39, 39, 39, 39, 39, 39, 257, 39, 39, 39, 39, 39, 39, 39, 39, 39, 39, 268, 39, 39, 39, 77,
77, 39, 39, 39, 39, 39, 39, 39, 39, 39, 39, 39, 39, 39, 39, 39, 39, 39, 39, 39, 257, 39, 39, 39, 39, 257, 39, 39, 39, 39, 257, 39, 39, 39, 257, 39, 268, 39, 39, 39, 39, 39, 39, 39, 39, 39, 39, 39, 39, 77,
77, 39, 39, 39, 39, 39, 268, 39, 39, 39, 39, 39, 39, 39, 39, 39, 39, 39, 39, 39, 39, 39, 39, 39, 39, 39, 39, 39, 39, 39, 39, 257, 39, 39, 39, 39, 261, 39, 39, 39, 39, 39, 39, 39, 39, 39, 39, 39, 39, 77,
77, 39, 39, 39, 39, 39, 39, 39, 39, 39, 39, 39, 39, 39, 39, 268, 39, 39, 39, 257, 268, 39, 39, 39, 39, 39, 39, 39, 39, 39, 39, 39, 39, 39, 39, 39, 39, 39, 39, 39, 39, 39, 39, 39, 39, 39, 39, 39, 39, 77,
77, 39, 39, 39, 39, 39, 39, 39, 39, 39, 39, 39, 39, 39, 39, 39, 39, 39, 39, 39, 39, 39, 39, 39, 39, 39, 39, 39, 39, 39, 39, 39, 39, 39, 39, 39, 39, 39, 39, 39, 39, 39, 39, 39, 39, 39, 39, 39, 39, 77,
77, 39, 39, 39, 39, 39, 39, 39, 39, 39, 257, 39, 39, 268, 39, 257, 39, 39, 39, 39, 39, 39, 39, 39, 39, 268, 39, 39, 39, 39, 39, 39, 39, 39, 39, 39, 39, 39, 39, 39, 39, 39, 39, 39, 39, 39, 39, 39, 39, 77,
77, 39, 39, 39, 39, 39, 39, 268, 39, 39, 39, 39, 39, 39, 39, 39, 39, 39, 39, 39, 39, 39, 39, 39, 39, 39, 39, 39, 39, 39, 39, 39, 39, 39, 39, 39, 39, 39, 39, 39, 39, 39, 39, 39, 39, 39, 39, 39, 39, 77,
77, 39, 39, 39, 39, 39, 39, 39, 39, 39, 39, 39, 39, 39, 39, 39, 39, 39, 39, 39, 39, 39, 39, 39, 39, 39, 39, 39, 39, 39, 39, 39, 39, 39, 39, 39, 39, 39, 39, 39, 39, 39, 39, 39, 39, 39, 39, 39, 39, 77,
77, 39, 39, 39, 39, 39, 39, 39, 39, 39, 39, 39, 39, 39, 39, 268, 39, 39, 39, 39, 39, 39, 268, 39, 39, 39, 39, 39, 39, 39, 39, 39, 39, 39, 39, 39, 39, 39, 39, 39, 39, 39, 39, 39, 39, 39, 39, 39, 39, 77,
77, 39, 39, 39, 39, 39, 39, 39, 39, 39, 39, 39, 39, 39, 39, 39, 39, 39, 39, 39, 39, 39, 39, 39, 39, 39, 39, 39, 39, 39, 39, 39, 39, 39, 39, 39, 39, 39, 268, 39, 39, 39, 39, 39, 39, 268, 39, 39, 39, 77,
77, 39, 39, 39, 39, 257, 39, 39, 39, 39, 39, 39, 39, 39, 39, 39, 39, 39, 39, 39, 39, 39, 39, 39, 39, 39, 39, 39, 39, 39, 39, 39, 39, 39, 39, 39, 39, 39, 39, 39, 39, 39, 39, 39, 39, 39, 39, 39, 39, 77,
77, 39, 39, 39, 39, 39, 39, 39, 39, 39, 39, 39, 39, 39, 39, 39, 39, 39, 39, 39, 39, 39, 39, 39, 39, 257, 39, 39, 39, 39, 39, 39, 39, 39, 268, 39, 39, 39, 39, 39, 39, 39, 39, 39, 39, 39, 39, 39, 39, 77,
77, 39, 39, 39, 39, 39, 39, 39, 39, 39, 268, 39, 39, 39, 39, 39, 39, 39, 39, 39, 39, 39, 39, 39, 39, 39, 39, 39, 39, 39, 39, 39, 39, 39, 39, 39, 39, 39, 39, 39, 39, 39, 39, 39, 39, 39, 39, 39, 39, 77,
77, 39, 39, 39, 39, 39, 39, 39, 287, 39, 39, 39, 39, 39, 39, 39, 39, 39, 39, 39, 39, 39, 39, 39, 39, 39, 39, 39, 39, 39, 39, 39, 39, 39, 39, 287, 39, 39, 39, 39, 39, 39, 39, 39, 39, 39, 39, 39, 39, 77,
77, 39, 39, 39, 39, 39, 39, 39, 288, 257, 39, 39, 39, 39, 39, 39, 39, 39, 39, 39, 39, 39, 39, 39, 39, 39, 39, 39, 39, 39, 39, 257, 39, 39, 39, 288, 39, 39, 39, 39, 39, 39, 39, 39, 39, 39, 39, 39, 39, 77,
77, 39, 39, 39, 39, 39, 39, 39, 288, 39, 39, 39, 39, 39, 39, 39, 39, 39, 39, 257, 39, 39, 287, 39, 39, 39, 39, 39, 39, 39, 39, 39, 39, 39, 39, 288, 39, 39, 39, 39, 39, 39, 268, 39, 39, 39, 39, 39, 39, 77,
77, 39, 39, 291, 291, 291, 291, 291, 290, 291, 291, 291, 291, 291, 291, 291, 291, 39, 39, 39, 39, 39, 257, 39, 39, 39, 39, 39, 291, 291, 291, 291, 291, 291, 291, 290, 291, 291, 291, 291, 291, 291, 291, 39, 39, 39, 39, 39, 39, 77,
77, 39, 39, 257, 39, 39, 257, 39, 288, 39, 39, 39, 39, 39, 39, 268, 39, 39, 39, 39, 39, 39, 39, 39, 39, 39, 39, 39, 39, 39, 39, 39, 39, 39, 39, 288, 39, 39, 39, 39, 39, 39, 39, 39, 39, 39, 39, 39, 39, 77,
77, 39, 39, 257, 39, 39, 39, 39, 288, 39, 39, 39, 257, 39, 39, 39, 39, 39, 39, 39, 39, 39, 39, 39, 39, 39, 39, 39, 39, 39, 268, 39, 39, 39, 268, 288, 39, 39, 39, 39, 39, 39, 39, 39, 39, 39, 39, 39, 39, 77,
77, 39, 39, 39, 39, 39, 39, 39, 39, 39, 39, 39, 39, 39, 39, 39, 39, 39, 39, 39, 39, 39, 39, 39, 39, 39, 39, 39, 39, 39, 39, 39, 39, 39, 39, 39, 39, 39, 39, 39, 39, 268, 39, 39, 39, 39, 39, 39, 39, 77,
77, 39, 39, 39, 39, 257, 39, 39, 39, 39, 257, 39, 39, 39, 39, 39, 39, 39, 39, 39, 39, 39, 39, 39, 39, 39, 39, 39, 39, 39, 39, 39, 39, 39, 39, 39, 39, 39, 39, 39, 39, 39, 39, 39, 39, 39, 39, 39, 39, 77,
77, 39, 39, 39, 39, 39, 39, 39, 39, 39, 39, 39, 39, 39, 39, 39, 39, 39, 39, 39, 39, 39, 39, 39, 39, 39, 39, 39, 39, 39, 39, 39, 39, 39, 39, 39, 39, 39, 39, 39, 39, 39, 39, 39, 39, 39, 39, 39, 39, 77,
77, 39, 39, 257, 39, 39, 39, 39, 39, 39, 257, 39, 39, 39, 39, 39, 39, 39, 39, 39, 39, 39, 39, 39, 39, 39, 39, 39, 39, 39, 39, 39, 39, 39, 39, 39, 39, 39, 39, 39, 39, 39, 39, 39, 39, 39, 39, 39, 39, 77,
77, 39, 39, 39, 39, 39, 39, 39, 39, 39, 39, 39, 39, 39, 39, 39, 39, 39, 39, 39, 39, 257, 39, 39, 39, 39, 39, 39, 39, 39, 39, 39, 39, 39, 39, 39, 39, 39, 39, 39, 39, 39, 39, 39, 39, 39, 39, 39, 39, 77,
77, 39, 39, 39, 39, 39, 39, 39, 39, 39, 39, 39, 39, 39, 39, 39, 39, 39, 39, 39, 39, 39, 39, 39, 39, 39, 39, 39, 39, 39, 39, 39, 39, 39, 39, 39, 39, 39, 39, 39, 39, 39, 39, 39, 39, 39, 39, 39, 39, 77,
77, 77, 77, 77, 77, 77, 77, 77, 77, 77, 77, 77, 77, 77, 77, 77, 77, 77, 77, 77, 77, 77, 77, 77, 77, 77, 77, 77, 77, 77, 77, 77, 77, 77, 77, 77, 77, 77, 77, 77, 77, 77, 77, 77, 77, 77, 77, 77, 77, 77