0, 0, 0, 0, 0, 0, 0, 0, 0, 0, 0, 0, 0, 0, 0, 0, 0, 0, 0, 0, 0, 0, 0, 0, 0, 0, 0, 0, 0, 0, 0, 0, 0, 0, 0, 0, 0, 0, 0, 0, 0, 0, 0, 0, 0, 0, 0, 0, 0, 0,
0, 55, 55, 55, 0, 0, 0, 55, 0, 0, 0, 0, 55, 0, 0, 0, 0, 55, 0, 0, 55, 0, 0, 0, 0, 0, 0, 0, 0, 55, 0, 0, 55, 0, 0, 0, 0, 0, 0, 0, 0, 0, 0, 0, 0, 0, 0, 0, 0, 0,
0, 0, 0, 55, 55, 55, 55, 55, 0, 0, 0, 0, 55, 0, 0, 0, 0, 55, 0, 0, 55, 0, 0, 55, 0, 0, 55, 0, 0, 55, 0, 0, 55, 0, 0, 55, 0, 0, 55, 0, 0, 0, 0, 0, 0, 0, 0, 0, 0, 0,
0, 0, 0, 55, 0, 0, 0, 55, 0, 0, 0, 0, 55, 0, 0, 0, 0, 55, 0, 0, 55, 0, 0, 55, 0, 0, 55, 0, 0, 55, 0, 0, 55, 0, 0, 55, 0, 0, 55, 0, 0, 0, 0, 0, 0, 0, 0, 0, 0, 0,
0, 55, 55, 55, 55, 55, 55, 55, 55, 55, 55, 55, 55, 0, 0, 0, 0, 55, 0, 0, 55, 0, 0, 55, 0, 0, 55, 0, 0, 55, 0, 0, 55, 0, 0, 55, 0, 0, 55, 0, 0, 0, 0, 0, 0, 0, 0, 0, 0, 0,
0, 0, 0, 55, 0, 0, 0, 55, 0, 0, 0, 0, 55, 0, 0, 0, 0, 55, 0, 0, 55, 0, 0, 55, 0, 0, 55, 0, 0, 55, 0, 0, 55, 0, 0, 55, 0, 0, 55, 0, 0, 0, 0, 0, 0, 0, 0, 0, 0, 0,
0, 0, 0, 55, 0, 0, 0, 55, 0, 0, 0, 0, 55, 0, 0, 0, 0, 55, 0, 0, 55, 0, 0, 55, 0, 0, 55, 0, 0, 55, 0, 0, 55, 0, 0, 55, 0, 0, 55, 0, 0, 0, 0, 0, 0, 0, 0, 0, 0, 0,
0, 55, 55, 55, 0, 0, 0, 55, 55, 55, 55, 55, 55, 0, 0, 0, 0, 55, 0, 0, 55, 0, 0, 55, 0, 0, 55, 0, 0, 55, 0, 0, 55, 0, 0, 55, 0, 0, 55, 0, 0, 0, 0, 0, 0, 0, 0, 0, 0, 0,
0, 0, 0, 0, 0, 0, 0, 0, 0, 0, 0, 0, 55, 0, 0, 0, 0, 0, 0, 0, 0, 0, 0, 55, 0, 0, 55, 0, 0, 0, 0, 0, 0, 0, 0, 55, 0, 0, 55, 0, 0, 0, 0, 0, 0, 0, 0, 0, 0, 0,
0, 29, 0, 0, 0, 0, 0, 0, 0, 0, 0, 0, 55, 55, 0, 0, 0, 0, 0, 0, 0, 0, 0, 0, 0, 0, 0, 0, 0, 0, 0, 0, 0, 0, 0, 0, 0, 0, 0, 0, 0, 0, 0, 0, 0, 0, 0, 0, 0, 0,
0, 0, 0, 0, 0, 0, 0, 0, 0, 0, 0, 3, 0, 0, 0, 0, 0, 0, 0, 55, 0, 0, 0, 55, 0, 0, 0, 0, 0, 0, 55, 0, 0, 55, 0, 0, 0, 55, 0, 0, 0, 0, 0, 0, 0, 0, 0, 0, 0, 0,
0, 29, 0, 0, 55, 0, 0, 0, 55, 0, 0, 0, 55, 0, 0, 0, 0, 0, 0, 0, 0, 0, 0, 0, 0, 0, 55, 0, 0, 0, 0, 0, 0, 0, 0, 0, 0, 0, 0, 0, 0, 55, 0, 0, 55, 0, 55, 0, 0, 0,
0, 55, 0, 0, 0, 0, 0, 0, 0, 0, 0, 0, 55, 0, 0, 0, 0, 0, 0, 0, 55, 0, 0, 55, 0, 0, 0, 0, 0, 0, 55, 0, 0, 0, 55, 0, 55, 0, 0, 0, 0, 0, 0, 0, 0, 0, 0, 0, 55, 0,
0, 0, 0, 0, 0, 0, 0, 0, 0, 55, 0, 0, 0, 55, 0, 0, 0, 0, 0, 0, 0, 0, 0, 0, 0, 0, 0, 0, 55, 0, 0, 0, 55, 0, 0, 0, 0, 0, 0, 55, 0, 0, 0, 0, 55, 0, 0, 0, 0, 0,
0, 0, 0, 55, 55, 0, 0, 0, 0, 0, 0, 0, 0, 0, 0, 0, 0, 0, 0, 0, 0, 0, 0, 0, 0, 0, 0, 0, 0, 0, 0, 0, 0, 0, 55, 0, 0, 0, 0, 0, 0, 55, 0, 0, 0, 0, 0, 55, 0, 0,
0, 0, 0, 0, 0, 0, 0, 0, 55, 0, 0, 0, 55, 0, 0, 55, 0, 0, 55, 0, 0, 0, 0, 0, 0, 0, 55, 0, 0, 0, 55, 0, 0, 0, 0, 0, 0, 0, 55, 0, 0, 0, 0, 0, 0, 0, 0, 0, 0, 0,
0, 0, 0, 55, 55, 0, 0, 0, 0, 0, 0, 0, 0, 0, 0, 0, 0, 0, 55, 0, 0, 55, 0, 0, 0, 55, 0, 0, 0, 0, 0, 0, 0, 0, 55, 0, 0, 0, 0, 0, 0, 0, 0, 0, 0, 55, 0, 0, 0, 0,
0, 0, 0, 55, 0, 0, 0, 0, 55, 0, 0, 0, 0, 0, 0, 55, 0, 0, 0, 0, 0, 55, 0, 55, 0, 0, 0, 0, 55, 55, 29, 0, 0, 0, 0, 0, 55, 0, 0, 0, 0, 55, 0, 0, 0, 0, 0, 55, 0, 0,
0, 0, 0, 0, 0, 0, 0, 0, 0, 0, 0, 55, 0, 55, 0, 0, 0, 0, 0, 0, 0, 0, 0, 0, 0, 0, 0, 3, 0, 0, 0, 0, 0, 0, 0, 0, 0, 0, 0, 0, 0, 0, 0, 0, 0, 0, 0, 0, 0, 0,
0, 0, 0, 0, 0, 55, 0, 55, 0, 0, 0, 0, 0, 0, 0, 29, 55, 0, 0, 55, 0, 55, 0, 0, 0, 0, 0, 55, 0, 0, 0, 0, 0, 0, 55, 0, 0, 55, 0, 0, 0, 0, 0, 0, 55, 0, 0, 55, 0, 0,
0, 0, 55, 0, 0, 0, 0, 0, 0, 0, 0, 0, 55, 0, 0, 0, 0, 0, 0, 0, 0, 0, 0, 0, 55, 0, 0, 0, 0, 0, 0, 0, 0, 0, 0, 0, 0, 0, 0, 0, 0, 55, 0, 0, 0, 0, 0, 0, 0, 0,
0, 0, 0, 0, 0, 55, 0, 0, 0, 55, 0, 0, 0, 0, 0, 0, 55, 0, 0, 55, 0, 55, 0, 0, 0, 0, 0, 0, 55, 0, 0, 55, 0, 0, 55, 0, 0, 0, 0, 0, 0, 0, 0, 55, 0, 55, 0, 0, 0, 0,
0, 55, 0, 55, 0, 0, 0, 0, 0, 0, 0, 0, 0, 0, 0, 0, 0, 0, 0, 0, 0, 0, 0, 0, 0, 0, 0, 0, 0, 0, 0, 0, 0, 0, 0, 0, 0, 0, 0, 0, 0, 0, 0, 0, 0, 0, 0, 55, 0, 0,
0, 0, 0, 0, 0, 55, 0, 0, 0, 0, 55, 0, 0, 0, 55, 0, 0, 0, 0, 0, 0, 0, 0, 0, 0, 0, 0, 0, 55, 0, 0, 0, 55, 0, 0, 0, 0, 55, 0, 0, 55, 0, 0, 0, 0, 55, 0, 0, 0, 0,
0, 0, 55, 0, 0, 55, 55, 55, 0, 0, 0, 0, 0, 0, 0, 0, 0, 55, 0, 0, 0, 0, 0, 0, 0, 0, 0, 0, 0, 0, 0, 0, 0, 0, 0, 0, 0, 0, 0, 0, 0, 0, 55, 0, 0, 0, 0, 0, 0, 0,
0, 29, 0, 0, 0, 55, 0, 0, 0, 0, 55, 0, 0, 0, 55, 0, 0, 0, 0, 55, 0, 0, 0, 0, 0, 0, 0, 55, 0, 0, 0, 0, 55, 0, 0, 0, 0, 55, 0, 0, 0, 0, 0, 0, 0, 55, 0, 0, 0, 0,
0, 0, 0, 0, 0, 0, 0, 0, 0, 0, 0, 0, 0, 0, 0, 3, 0, 0, 0, 0, 0, 0, 0, 0, 0, 0, 0, 0, 0, 55, 0, 0, 0, 0, 0, 0, 0, 0, 55, 0, 0, 55, 0, 0, 0, 0, 0, 55, 0, 0,
0, 29, 0, 0, 0, 0, 0, 0, 0, 0, 0, 55, 0, 0, 0, 0, 0, 0, 0, 0, 0, 0, 55, 0, 0, 0, 0, 0, 0, 0, 0, 55, 0, 0, 0, 55, 0, 0, 0, 0, 0, 0, 0, 0, 55, 0, 0, 0, 0, 0,
0, 0, 0, 0, 55, 0, 55, 0, 0, 55, 0, 0, 0, 0, 0, 0, 0, 0, 0, 55, 0, 0, 0, 0, 0, 0, 0, 0, 55, 0, 0, 0, 0, 0, 0, 0, 0, 0, 0, 0, 55, 0, 0, 0, 0, 0, 0, 0, 0, 0,
0, 55, 0, 0, 0, 0, 0, 0, 0, 0, 0, 0, 55, 0, 0, 0, 55, 0, 0, 0, 0, 0, 0, 0, 0, 0, 0, 0, 0, 0, 0, 0, 0, 55, 0, 0, 0, 0, 0, 0, 0, 0, 55, 0, 0, 0, 0, 55, 0, 0,
0, 0, 0, 0, 0, 0, 0, 0, 0, 0, 0, 0, 0, 0, 0, 0, 0, 0, 0, 0, 0, 0, 0, 0, 0, 0, 0, 0, 55, 0, 0, 55, 0, 0, 0, 0, 55, 0, 0, 55, 0, 0, 0, 0, 0, 55, 0, 0, 0, 0,
0, 0, 55, 0, 0, 0, 0, 55, 0, 0, 55, 0, 0, 0, 0, 55, 0, 0, 0, 55, 0, 0, 55, 29, 0, 0, 55, 0, 0, 0, 0, 0, 0, 55, 0, 0, 0, 0, 0, 0, 0, 0, 0, 55, 0, 0, 0, 0, 55, 0,
0, 0, 0, 0, 0, 0, 0, 0, 0, 0, 0, 0, 0, 0, 0, 0, 0, 0, 0, 0, 0, 0, 0, 0, 0, 3, 0, 0, 0, 0, 0, 0, 0, 0, 0, 0, 0, 0, 0, 0, 0, 0, 0, 0, 0, 0, 0, 0, 0, 0,
0, 0, 0, 0, 0, 0, 0, 55, 0, 0, 0, 0, 0, 55, 0, 0, 55, 0, 0, 0, 0, 0, 0, 55, 0, 0, 0, 29, 0, 0, 0, 0, 0, 0, 0, 0, 0, 0, 0, 55, 0, 0, 0, 0, 0, 0, 0, 0, 0, 0,
0, 0, 0, 0, 0, 0, 0, 0, 0, 0, 55, 0, 0, 0, 0, 0, 0, 0, 55, 0, 0, 0, 0, 0, 0, 0, 0, 0, 0, 0, 0, 0, 55, 0, 0, 0, 0, 0, 0, 55, 0, 0, 55, 0, 0, 0, 0, 0, 0, 0,
0, 0, 0, 0, 0, 0, 55, 0, 55, 0, 0, 0, 0, 55, 0, 0, 0, 0, 0, 0, 0, 0, 0, 0, 0, 0, 0, 0, 0, 55, 0, 0, 55, 0, 0, 0, 0, 0, 0, 55, 0, 0, 0, 55, 0, 0, 55, 0, 0, 0,
0, 0, 55, 0, 0, 0, 0, 0, 0, 0, 0, 0, 0, 0, 0, 0, 0, 55, 0, 0, 0, 0, 0, 0, 0, 55, 0, 0, 0, 0, 0, 0, 55, 0, 0, 0, 0, 0, 0, 0, 0, 0, 0, 55, 0, 0, 0, 55, 0, 0,
0, 0, 0, 0, 0, 0, 0, 0, 0, 0, 0, 0, 0, 0, 0, 0, 0, 0, 0, 55, 0, 0, 55, 0, 0, 55, 0, 0, 0, 0, 0, 0, 0, 0, 0, 0, 0, 0, 0, 0, 0, 0, 0, 55, 55, 55, 0, 0, 55, 0,
0, 0, 0, 0, 0, 0, 0, 0, 0, 0, 0, 0, 0, 0, 0, 0, 0, 0, 0, 0, 0, 0, 0, 0, 0, 0, 0, 0, 0, 0, 0, 0, 0, 0, 0, 0, 0, 0, 0, 0, 0, 0, 0, 0, 0, 0, 0, 0, 0, 0,
0, 0, 0, 0, 0, 0, 0, 0, 0, 0, 0, 0, 0, 0, 0, 0, 0, 0, 0, 0, 0, 0, 0, 0, 0, 0, 0, 0, 0, 0, 0, 0, 0, 0, 0, 0, 0, 0, 0, 0, 0, 0, 0, 55, 55, 55, 55, 55, 55, 0,
0, 0, 0, 0, 0, 0, 0, 0, 0, 0, 0, 0, 0, 0, 0, 0, 0, 0, 0, 55, 55, 0, 0, 55, 55, 55, 55, 55, 0, 0, 0, 0, 0, 0, 0, 0, 0, 0, 0, 0, 0, 0, 0, 55, 55, 55, 55, 55, 55, 0,
0, 0, 55, 0, 0, 0, 0, 0, 0, 0, 0, 0, 0, 0, 0, 0, 0, 55, 55, 55, 55, 0, 0, 55, 55, 55, 55, 55, 0, 0, 0, 0, 0, 0, 0, 0, 0, 0, 0, 0, 0, 0, 0, 55, 0, 55, 0, 0, 0, 0,
0, 0, 0, 0, 0, 0, 0, 0, 0, 0, 0, 0, 0, 0, 0, 0, 0, 55, 55, 55, 55, 0, 55, 55, 55, 55, 55, 55, 0, 0, 0, 0, 0, 0, 0, 0, 0, 0, 0, 0, 0, 0, 0, 55, 0, 55, 0, 0, 0, 0,
0, 55, 0, 0, 0, 0, 0, 0, 55, 0, 0, 0, 0, 0, 55, 0, 0, 55, 55, 0, 0, 0, 0, 55, 55, 55, 55, 55, 55, 55, 55, 55, 55, 55, 55, 55, 55, 55, 55, 55, 55, 55, 55, 0, 0, 0, 1, 0, 0, 0,
0, 0, 0, 0, 0, 0, 0, 0, 0, 29, 0, 0, 55, 0, 55, 0, 55, 55, 55, 55, 0, 0, 55, 55, 55, 0, 55, 55, 55, 55, 55, 55, 55, 55, 55, 55, 55, 55, 55, 55, 55, 0, 0, 0, 0, 0, 0, 0, 29, 0,
0, 0, 0, 0, 55, 0, 0, 55, 0, 0, 55, 0, 0, 0, 55, 0, 0, 55, 55, 0, 0, 0, 55, 0, 0, 55, 0, 0, 55, 0, 0, 55, 0, 0, 55, 0, 0, 55, 0, 0, 55, 0, 0, 0, 0, 0, 55, 55, 55, 0,
0, 0, 0, 0, 0, 0, 0, 0, 0, 0, 0, 0, 0, 0, 55, 0, 0, 55, 55, 55, 55, 55, 55, 55, 55, 55, 55, 55, 55, 55, 55, 55, 55, 55, 55, 55, 55, 55, 55, 55, 55, 55, 0, 0, 0, 0, 0, 0, 0, 0,
0, 0, 0, 0, 0, 55, 0, 0, 0, 55, 0, 55, 0, 0, 55, 55, 0, 0, 0, 0, 0, 0, 55, 55, 55, 55, 55, 0, 0, 55, 55, 0, 0, 55, 0, 55, 0, 0, 55, 0, 0, 0, 0, 0, 55, 55, 0, 0, 21, 0,
0, 55, 0, 0, 0, 0, 0, 0, 0, 0, 0, 0, 0, 0, 0, 0, 0, 0, 55, 0, 0, 0, 55, 55, 55, 55, 55, 55, 55, 55, 55, 55, 55, 55, 55, 55, 55, 55, 55, 55, 55, 55, 0, 0, 0, 0, 0, 0, 0, 0,
0, 0, 0, 0, 0, 0, 0, 0, 0, 0, 0, 0, 0, 0, 0, 0, 0, 0, 0, 0, 0, 0, 0, 0, 0, 0, 0, 0, 0, 0, 0, 0, 0, 0, 0, 0, 0, 0, 0, 0, 0, 0, 0, 0, 0, 0, 0, 0, 0, 0