0, 0, 0, 0, 0, 0, 0, 0, 0, 0, 0, 0, 0, 0, 0, 0, 0, 0, 0, 0, 0, 0, 0, 0, 0, 0, 0, 0, 0, 0, 0, 0, 0, 0, 0, 0, 0, 0, 0, 0,
0, 0, 0, 0, 0, 0, 0, 0, 0, 0, 0, 0, 0, 0, 0, 0, 0, 0, 0, 0, 0, 0, 0, 0, 250, 0, 0, 250, 0, 0, 250, 0, 0, 250, 0, 0, 250, 0, 0, 0,
0, 0, 0, 0, 0, 0, 0, 0, 0, 0, 0, 0, 0, 0, 0, 0, 0, 0, 0, 0, 0, 0, 0, 0, 0, 0, 0, 0, 0, 0, 0, 0, 0, 0, 0, 0, 0, 0, 0, 0,
0, 0, 0, 271, 0, 0, 0, 0, 0, 0, 0, 0, 0, 0, 0, 0, 0, 0, 0, 0, 0, 0, 0, 271, 0, 0, 271, 0, 0, 271, 0, 0, 271, 0, 0, 0, 0, 0, 0, 0,
0, 236, 0, 271, 0, 0, 0, 0, 0, 0, 0, 0, 0, 0, 0, 0, 0, 0, 0, 0, 0, 0, 0, 271, 0, 0, 271, 0, 0, 271, 0, 0, 271, 0, 0, 0, 0, 0, 0, 0,
0, 0, 0, 271, 0, 0, 245, 0, 0, 0, 0, 0, 0, 0, 0, 0, 0, 0, 0, 0, 0, 0, 0, 271, 0, 0, 271, 0, 0, 271, 0, 0, 271, 0, 0, 0, 0, 0, 0, 0,
0, 0, 0, 0, 0, 0, 0, 0, 0, 0, 0, 0, 0, 0, 0, 0, 0, 0, 0, 0, 0, 0, 217, 0, 0, 0, 0, 0, 0, 0, 0, 0, 0, 0, 0, 0, 0, 0, 0, 0,
0, 262, 263, 264, 0, 0, 0, 0, 0, 0, 0, 0, 0, 0, 0, 0, 0, 0, 0, 0, 0, 0, 0, 245, 0, 0, 0, 0, 0, 0, 0, 0, 0, 0, 0, 0, 0, 0, 0, 0,
0, 0, 0, 271, 271, 271, 271, 271, 271, 271, 271, 271, 271, 262, 263, 264, 0, 0, 271, 271, 271, 271, 271, 271, 271, 271, 271, 271, 0, 0, 271, 271, 271, 271, 271, 271, 0, 0, 0, 0,
0, 0, 0, 271, 0, 0, 0, 0, 0, 0, 0, 0, 271, 0, 0, 0, 0, 0, 271, 0, 0, 0, 0, 0, 0, 0, 0, 271, 0, 0, 271, 0, 0, 0, 0, 271, 262, 263, 264, 0,
0, 0, 0, 271, 0, 0, 0, 0, 0, 0, 0, 0, 271, 0, 0, 0, 0, 0, 271, 0, 0, 0, 0, 0, 0, 0, 0, 271, 0, 0, 271, 0, 0, 0, 0, 271, 0, 0, 0, 0,
0, 0, 0, 271, 0, 0, 0, 0, 0, 0, 0, 0, 271, 0, 0, 262, 263, 264, 271, 0, 0, 0, 0, 0, 0, 0, 0, 271, 0, 0, 271, 0, 0, 0, 0, 271, 0, 0, 0, 0,
0, 0, 0, 271, 0, 0, 0, 0, 0, 0, 0, 0, 271, 0, 0, 0, 0, 0, 271, 0, 0, 0, 0, 0, 0, 0, 0, 271, 0, 0, 271, 0, 0, 0, 0, 271, 0, 0, 0, 0,
0, 0, 0, 271, 0, 0, 0, 0, 0, 0, 0, 0, 271, 0, 0, 0, 0, 0, 271, 271, 271, 0, 0, 0, 0, 0, 0, 271, 0, 0, 271, 0, 0, 0, 0, 271, 262, 263, 264, 0,
0, 0, 0, 271, 271, 271, 271, 271, 271, 271, 271, 271, 271, 0, 262, 263, 264, 0, 0, 0, 271, 271, 271, 271, 271, 271, 271, 271, 0, 0, 271, 0, 0, 0, 0, 271, 0, 0, 0, 0,
0, 0, 0, 0, 0, 0, 0, 0, 0, 0, 0, 0, 0, 0, 0, 0, 0, 0, 0, 0, 0, 0, 0, 0, 0, 0, 0, 0, 0, 0, 271, 0, 0, 0, 0, 271, 0, 0, 0, 0,
0, 262, 263, 264, 0, 0, 0, 0, 0, 0, 0, 0, 0, 0, 0, 0, 0, 0, 0, 0, 0, 0, 0, 0, 0, 0, 0, 262, 263, 264, 271, 0, 0, 0, 0, 271, 0, 0, 0, 0,
0, 0, 0, 0, 0, 0, 0, 0, 0, 0, 0, 0, 0, 0, 0, 0, 0, 0, 0, 0, 0, 0, 0, 0, 0, 0, 0, 0, 0, 0, 271, 0, 0, 0, 0, 271, 0, 0, 0, 0,
0, 271, 271, 271, 271, 271, 271, 271, 271, 271, 271, 271, 271, 0, 0, 319, 0, 237, 0, 319, 0, 0, 0, 0, 0, 0, 0, 0, 0, 0, 271, 0, 0, 0, 0, 271, 262, 263, 264, 0,
0, 0, 0, 0, 0, 0, 0, 0, 0, 0, 0, 0, 0, 0, 0, 0, 0, 0, 0, 0, 0, 0, 0, 0, 0, 0, 0, 0, 0, 0, 271, 0, 0, 0, 0, 271, 0, 0, 0, 0,
0, 0, 0, 0, 0, 0, 0, 0, 0, 0, 0, 0, 0, 0, 271, 271, 271, 271, 271, 271, 271, 271, 0, 0, 0, 0, 0, 0, 0, 0, 271, 0, 0, 0, 0, 271, 0, 0, 0, 0,
0, 0, 0, 0, 0, 0, 271, 271, 271, 271, 271, 271, 271, 0, 262, 263, 263, 263, 263, 263, 263, 264, 0, 0, 0, 0, 0, 0, 0, 0, 271, 0, 0, 0, 0, 271, 262, 263, 264, 0,
0, 0, 0, 0, 0, 0, 0, 0, 0, 0, 0, 0, 0, 0, 0, 0, 0, 0, 0, 0, 0, 0, 0, 0, 0, 0, 0, 0, 0, 0, 271, 271, 271, 271, 271, 271, 0, 0, 0, 0,
0, 271, 271, 271, 271, 271, 271, 271, 271, 0, 0, 0, 0, 0, 271, 271, 271, 271, 271, 271, 271, 271, 0, 0, 0, 0, 0, 0, 0, 0, 0, 0, 0, 0, 0, 0, 0, 0, 0, 0,
0, 0, 0, 0, 0, 0, 0, 0, 0, 0, 0, 0, 0, 0, 0, 0, 262, 263, 264, 0, 0, 0, 0, 0, 0, 0, 0, 0, 262, 263, 264, 0, 0, 0, 0, 0, 0, 0, 0, 0,
0, 0, 0, 0, 0, 0, 0, 0, 0, 0, 0, 0, 0, 0, 0, 0, 0, 0, 0, 0, 0, 0, 0, 0, 0, 0, 0, 0, 0, 0, 0, 0, 0, 0, 0, 0, 0, 0, 0, 0,
0, 0, 0, 0, 0, 0, 0, 0, 0, 0, 0, 0, 0, 0, 0, 0, 0, 0, 0, 0, 0, 0, 0, 0, 0, 0, 0, 0, 0, 0, 0, 0, 0, 0, 0, 0, 0, 0, 0, 0,
0, 0, 0, 0, 0, 0, 0, 0, 0, 0, 0, 262, 263, 264, 0, 0, 0, 0, 0, 0, 0, 0, 0, 0, 0, 0, 0, 0, 0, 0, 0, 0, 0, 0, 0, 0, 0, 0, 0, 0,
0, 0, 0, 271, 271, 271, 271, 271, 271, 271, 0, 0, 0, 0, 0, 0, 0, 0, 0, 0, 0, 0, 0, 271, 271, 271, 271, 271, 271, 271, 271, 271, 271, 0, 0, 0, 0, 0, 0, 0,
0, 0, 0, 271, 0, 0, 0, 0, 0, 271, 0, 0, 271, 271, 271, 271, 262, 263, 264, 0, 0, 0, 0, 271, 0, 0, 0, 0, 0, 0, 0, 0, 271, 0, 0, 0, 0, 0, 0, 0,
0, 0, 0, 271, 0, 0, 0, 0, 0, 271, 0, 0, 271, 0, 0, 271, 0, 0, 0, 0, 0, 0, 0, 271, 0, 0, 0, 0, 0, 0, 0, 0, 271, 0, 0, 0, 0, 0, 0, 0,
0, 0, 0, 271, 0, 0, 0, 0, 0, 271, 0, 0, 271, 0, 0, 271, 0, 0, 0, 262, 263, 264, 0, 271, 0, 0, 0, 0, 0, 0, 0, 0, 271, 0, 0, 0, 0, 0, 0, 0,
0, 0, 0, 271, 0, 0, 0, 0, 0, 271, 0, 0, 271, 271, 271, 271, 0, 0, 0, 0, 0, 0, 0, 271, 0, 0, 0, 0, 0, 0, 0, 0, 271, 0, 0, 0, 0, 0, 0, 0,
0, 0, 0, 271, 271, 271, 271, 271, 271, 271, 0, 0, 0, 0, 0, 0, 0, 0, 0, 0, 0, 0, 0, 271, 0, 0, 0, 0, 0, 0, 0, 0, 271, 0, 0, 0, 0, 0, 0, 0,
0, 0, 0, 0, 0, 0, 0, 0, 0, 0, 0, 0, 0, 0, 0, 0, 0, 0, 0, 0, 0, 0, 0, 271, 271, 271, 271, 271, 271, 271, 271, 271, 271, 0, 0, 0, 0, 0, 0, 0,
0, 0, 0, 0, 0, 0, 0, 0, 0, 0, 0, 0, 0, 0, 0, 0, 0, 0, 0, 0, 0, 0, 0, 0, 0, 0, 0, 0, 0, 0, 0, 0, 0, 0, 0, 0, 0, 0, 0, 0,
0, 0, 0, 0, 0, 0, 0, 0, 0, 0, 0, 0, 0, 0, 0, 0, 0, 0, 0, 0, 0, 0, 0, 0, 0, 0, 0, 0, 0, 0, 0, 0, 0, 0, 0, 0, 0, 0, 0, 0,
0, 0, 0, 0, 0, 0, 0, 0, 0, 0, 0, 0, 0, 0, 0, 0, 0, 0, 0, 0, 0, 0, 0, 0, 0, 0, 0, 0, 0, 0, 0, 0, 0, 0, 0, 0, 0, 0, 0, 0,
0, 0, 0, 0, 0, 0, 0, 0, 0, 0, 0, 0, 0, 0, 0, 0, 0, 0, 0, 0, 0, 0, 0, 0, 0, 0, 0, 0, 0, 0, 0, 0, 0, 0, 0, 0, 0, 0, 0, 0,
0, 0, 0, 0, 0, 0, 0, 0, 0, 0, 0, 0, 0, 0, 0, 0, 0, 0, 0, 0, 0, 0, 0, 0, 0, 0, 0, 0, 0, 0, 0, 0, 0, 0, 0, 0, 0, 0, 0, 0