77, 77, 77, 77, 77, 77, 77, 77, 77, 77, 77, 77, 77, 77, 77, 77, 77, 77, 77, 77, 77, 77, 77, 77, 77, 77, 77, 77, 77, 77, 77, 77, 77, 77, 77, 77, 77, 77, 77, 77,
77, 77, 77, 77, 77, 77, 77, 77, 77, 77, 77, 77, 77, 77, 77, 77, 77, 77, 77, 77, 77, 77, 77, 77, 77, 77, 77, 77, 77, 39, 39, 39, 39, 39, 39, 39, 42, 42, 39, 77,
0, 0, 0, 0, 0, 0, 0, 0, 0, 0, 0, 0, 0, 0, 0, 0, 0, 0, 0, 0, 77, 77, 77, 77, 77, 77, 77, 77, 77, 42, 42, 39, 42, 42, 39, 42, 39, 39, 39, 77,
40, 40, 40, 40, 40, 40, 40, 40, 40, 40, 40, 40, 40, 40, 40, 40, 40, 40, 40, 0, 77, 77, 77, 77, 77, 77, 77, 77, 77, 39, 39, 39, 39, 39, 40, 77, 39, 39, 39, 77,
40, 0, 40, 40, 40, 40, 40, 40, 40, 40, 40, 40, 40, 40, 40, 40, 40, 40, 40, 0, 77, 77, 77, 77, 77, 77, 77, 77, 77, 39, 39, 42, 77, 77, 77, 77, 77, 77, 77, 77,
40, 40, 40, 40, 40, 40, 40, 40, 40, 40, 40, 40, 40, 40, 40, 40, 40, 40, 40, 0, 77, 77, 77, 77, 77, 77, 77, 77, 77, 42, 39, 39, 77, 77, 77, 77, 77, 77, 77, 77,
40, 40, 40, 40, 40, 40, 40, 40, 40, 40, 40, 40, 40, 40, 40, 40, 40, 40, 40, 0, 77, 77, 77, 77, 77, 77, 77, 77, 77, 41, 41, 41, 77, 77, 77, 77, 77, 77, 77, 77,
40, 40, 40, 40, 40, 40, 40, 40, 40, 40, 40, 40, 40, 40, 40, 40, 40, 40, 40, 0, 77, 77, 77, 77, 77, 77, 77, 77, 77, 40, 40, 40, 77, 77, 77, 77, 77, 77, 77, 77,
40, 40, 40, 40, 40, 40, 40, 40, 40, 71, 40, 40, 40, 40, 40, 40, 40, 40, 40, 0, 77, 77, 77, 77, 77, 77, 77, 77, 77, 40, 40, 40, 77, 77, 77, 77, 77, 77, 77, 77,
40, 40, 40, 40, 40, 40, 40, 40, 40, 72, 40, 40, 40, 40, 40, 40, 40, 40, 40, 0, 77, 77, 77, 77, 77, 77, 77, 77, 77, 40, 40, 40, 77, 77, 77, 77, 77, 77, 77, 77,
40, 40, 40, 40, 40, 40, 40, 40, 40, 72, 40, 40, 40, 40, 40, 40, 40, 40, 40, 0, 77, 77, 77, 77, 77, 77, 77, 77, 77, 40, 40, 40, 77, 77, 77, 77, 77, 77, 77, 77,
40, 40, 40, 40, 40, 40, 40, 40, 40, 72, 40, 40, 40, 40, 40, 40, 40, 40, 40, 0, 77, 77, 77, 77, 77, 77, 77, 77, 77, 40, 40, 40, 77, 77, 77, 77, 77, 77, 77, 77,
40, 40, 40, 40, 40, 40, 40, 40, 40, 72, 40, 40, 40, 40, 40, 40, 40, 40, 40, 40, 40, 40, 40, 40, 40, 40, 40, 40, 40, 40, 40, 40, 77, 77, 77, 77, 77, 77, 77, 77,
40, 40, 40, 40, 40, 40, 40, 40, 40, 72, 40, 40, 40, 40, 40, 40, 40, 40, 40, 40, 40, 40, 40, 40, 40, 40, 40, 40, 40, 40, 40, 40, 77, 77, 77, 77, 77, 77, 77, 77,
40, 40, 40, 40, 40, 40, 40, 40, 40, 72, 40, 40, 40, 40, 40, 40, 40, 40, 40, 0, 77, 77, 77, 77, 77, 77, 77, 77, 77, 77, 40, 40, 40, 40, 77, 77, 77, 77, 77, 77,
40, 40, 40, 40, 40, 40, 40, 40, 40, 72, 40, 40, 40, 40, 40, 40, 40, 40, 40, 0, 77, 77, 77, 77, 77, 77, 77, 77, 77, 77, 40, 40, 40, 40, 40, 40, 40, 40, 40, 77,
40, 40, 40, 40, 40, 40, 40, 40, 40, 40, 40, 40, 40, 40, 40, 40, 40, 40, 40, 0, 77, 77, 77, 77, 77, 77, 77, 77, 77, 77, 40, 40, 40, 40, 40, 40, 40, 40, 40, 77,
40, 40, 40, 40, 40, 40, 40, 40, 40, 40, 40, 40, 40, 40, 40, 40, 40, 40, 40, 0, 77, 77, 77, 77, 77, 77, 77, 77, 77, 77, 40, 40, 40, 40, 40, 40, 40, 40, 40, 77,
40, 40, 40, 40, 40, 40, 40, 40, 40, 40, 40, 40, 40, 40, 40, 40, 40, 40, 40, 0, 77, 77, 77, 77, 77, 77, 77, 77, 77, 77, 40, 40, 40, 40, 77, 77, 40, 40, 40, 77,
40, 40, 40, 40, 40, 40, 40, 40, 40, 40, 40, 40, 40, 40, 40, 40, 40, 40, 40, 0, 77, 77, 77, 77, 77, 77, 77, 77, 77, 77, 77, 77, 77, 77, 77, 77, 40, 40, 40, 77,
40, 40, 40, 40, 40, 40, 40, 40, 40, 40, 40, 40, 40, 40, 40, 40, 40, 40, 40, 0, 0, 0, 0, 0, 0, 0, 0, 0, 0, 0, 0, 77, 77, 77, 77, 77, 40, 40, 40, 77,
40, 40, 40, 40, 40, 40, 40, 40, 40, 40, 40, 40, 40, 40, 40, 40, 40, 40, 40, 40, 40, 40, 40, 40, 40, 40, 40, 40, 40, 40, 77, 77, 77, 77, 77, 77, 40, 40, 40, 77,
40, 40, 40, 40, 40, 40, 40, 40, 40, 40, 40, 40, 40, 40, 40, 40, 40, 40, 40, 40, 40, 40, 40, 40, 40, 40, 40, 40, 40, 40, 77, 77, 77, 77, 77, 77, 40, 40, 40, 77,
40, 40, 40, 40, 40, 40, 40, 40, 40, 40, 40, 40, 40, 40, 40, 40, 40, 40, 40, 40, 40, 40, 40, 40, 40, 40, 40, 40, 40, 40, 77, 77, 77, 77, 77, 77, 40, 40, 40, 77,
40, 40, 40, 40, 40, 40, 40, 40, 40, 40, 40, 40, 40, 40, 40, 40, 40, 40, 40, 40, 40, 40, 40, 40, 40, 40, 40, 40, 40, 40, 77, 77, 77, 77, 77, 77, 40, 40, 40, 77,
40, 40, 40, 40, 40, 40, 40, 40, 40, 40, 40, 40, 40, 40, 40, 40, 40, 40, 40, 40, 40, 40, 40, 40, 40, 40, 40, 40, 40, 40, 77, 77, 77, 77, 77, 77, 40, 40, 40, 77,
40, 40, 40, 40, 40, 40, 40, 40, 40, 40, 40, 40, 40, 40, 40, 40, 40, 40, 40, 40, 40, 40, 40, 40, 40, 40, 40, 40, 40, 40, 77, 77, 77, 77, 77, 77, 40, 40, 40, 77,
40, 40, 40, 40, 40, 40, 40, 40, 40, 40, 40, 40, 40, 40, 40, 40, 40, 40, 40, 40, 40, 40, 40, 40, 40, 40, 40, 40, 40, 40, 77, 77, 77, 77, 77, 77, 40, 40, 40, 77,
40, 40, 40, 40, 40, 40, 40, 40, 40, 40, 40, 40, 40, 40, 40, 40, 40, 40, 40, 40, 40, 40, 40, 40, 40, 40, 40, 40, 40, 40, 77, 77, 77, 77, 77, 77, 40, 40, 40, 77,
40, 40, 40, 40, 40, 40, 40, 40, 40, 40, 40, 40, 40, 40, 40, 40, 40, 40, 40, 40, 40, 40, 40, 40, 40, 40, 40, 40, 40, 40, 77, 77, 77, 77, 77, 77, 40, 40, 40, 77,
40, 40, 40, 40, 40, 40, 40, 40, 40, 40, 40, 40, 40, 40, 40, 40, 40, 40, 40, 40, 40, 40, 40, 40, 40, 40, 40, 40, 40, 40, 77, 77, 77, 77, 77, 77, 40, 40, 40, 77,
40, 40, 40, 40, 40, 40, 40, 40, 40, 40, 40, 40, 40, 40, 40, 40, 40, 40, 40, 40, 40, 40, 40, 40, 40, 40, 40, 40, 40, 40, 77, 77, 77, 77, 77, 77, 40, 40, 40, 77,
40, 40, 40, 40, 40, 40, 40, 40, 40, 40, 40, 40, 40, 40, 40, 40, 40, 40, 40, 40, 40, 40, 40, 40, 40, 40, 40, 40, 40, 40, 77, 77, 77, 77, 77, 77, 40, 40, 40, 77,
40, 40, 40, 40, 40, 40, 40, 40, 40, 40, 40, 40, 40, 40, 40, 40, 40, 40, 40, 40, 40, 40, 40, 40, 40, 40, 40, 40, 40, 40, 77, 77, 40, 40, 40, 40, 40, 40, 40, 77,
40, 40, 40, 40, 40, 40, 40, 40, 40, 40, 40, 40, 40, 40, 40, 40, 40, 40, 40, 40, 40, 40, 40, 40, 40, 40, 40, 40, 40, 40, 77, 77, 40, 40, 40, 40, 40, 40, 40, 77,
40, 40, 40, 40, 40, 40, 40, 40, 40, 40, 40, 40, 40, 40, 40, 40, 40, 40, 40, 40, 40, 40, 40, 40, 40, 40, 40, 40, 40, 40, 77, 77, 40, 40, 40, 40, 40, 40, 40, 77,
40, 40, 40, 40, 40, 40, 40, 40, 40, 40, 40, 40, 40, 40, 40, 40, 40, 40, 40, 40, 40, 40, 40, 40, 40, 40, 40, 40, 40, 40, 77, 77, 40, 40, 40, 40, 40, 40, 40, 77,
40, 40, 40, 40, 40, 40, 40, 40, 40, 40, 40, 40, 40, 40, 40, 40, 40, 40, 40, 40, 40, 40, 40, 40, 40, 40, 40, 40, 40, 40, 77, 77, 40, 40, 40, 40, 40, 40, 40, 77,
40, 40, 40, 40, 40, 40, 40, 40, 40, 40, 40, 40, 40, 40, 40, 40, 40, 40, 40, 40, 40, 40, 40, 40, 40, 40, 40, 40, 40, 40, 77, 77, 40, 40, 40, 40, 40, 40, 40, 77,
40, 40, 40, 40, 40, 40, 40, 40, 40, 40, 40, 40, 40, 40, 40, 40, 40, 40, 40, 40, 40, 40, 40, 40, 40, 40, 40, 40, 40, 40, 77, 77, 77, 77, 77, 77, 77, 77, 77, 77