77, 77, 77, 77, 77, 77, 77, 77, 77, 77, 77, 77, 77, 77, 77, 77, 77, 77, 77, 77, 77, 77, 77, 77, 77, 77, 77, 77, 77, 77, 77, 77, 77, 77, 77, 77, 77, 77, 77, 77, 77, 77, 77, 77, 77, 77, 77, 77, 77, 77,
77, 77, 77, 77, 77, 77, 77, 77, 77, 77, 77, 77, 77, 77, 77, 77, 77, 77, 77, 77, 77, 77, 77, 77, 77, 77, 77, 77, 77, 77, 77, 77, 77, 77, 77, 77, 77, 77, 77, 77, 77, 77, 77, 77, 77, 77, 77, 77, 77, 77,
77, 77, 20, 20, 20, 20, 20, 20, 20, 20, 20, 20, 20, 20, 20, 20, 20, 20, 20, 20, 20, 20, 20, 20, 20, 20, 20, 20, 20, 20, 20, 20, 20, 20, 20, 20, 20, 20, 20, 20, 20, 20, 20, 20, 20, 20, 20, 20, 20, 77,
77, 77, 20, 20, 22, 20, 20, 20, 22, 20, 20, 22, 20, 20, 20, 20, 20, 20, 20, 20, 20, 20, 20, 20, 20, 20, 20, 20, 20, 20, 20, 20, 20, 20, 20, 20, 20, 20, 20, 20, 20, 22, 20, 20, 20, 20, 20, 20, 20, 77,
77, 77, 20, 20, 20, 20, 22, 20, 20, 20, 20, 22, 20, 20, 20, 20, 20, 20, 20, 20, 20, 20, 22, 20, 20, 20, 20, 20, 20, 20, 20, 20, 20, 20, 22, 20, 20, 20, 20, 20, 20, 20, 20, 20, 22, 20, 20, 20, 20, 77,
77, 77, 20, 20, 20, 20, 20, 20, 20, 20, 20, 20, 20, 20, 20, 20, 20, 20, 20, 20, 20, 20, 20, 20, 20, 22, 20, 20, 20, 20, 20, 20, 20, 20, 20, 20, 20, 20, 20, 22, 20, 20, 20, 20, 20, 20, 20, 20, 20, 77,
77, 77, 20, 20, 20, 20, 20, 22, 20, 20, 20, 20, 20, 20, 20, 22, 20, 20, 20, 20, 20, 20, 20, 20, 20, 20, 20, 22, 20, 20, 20, 20, 20, 20, 20, 20, 20, 20, 20, 20, 22, 20, 20, 20, 20, 22, 20, 20, 20, 77,
77, 77, 20, 20, 20, 20, 20, 20, 20, 20, 20, 20, 20, 20, 20, 20, 20, 20, 20, 20, 22, 20, 20, 20, 20, 20, 20, 20, 20, 20, 20, 20, 20, 20, 20, 20, 20, 20, 22, 20, 20, 20, 20, 22, 20, 20, 20, 20, 20, 77,
77, 77, 20, 20, 22, 20, 20, 20, 20, 20, 20, 20, 20, 20, 20, 20, 20, 20, 20, 20, 22, 20, 20, 20, 20, 20, 20, 20, 20, 20, 20, 20, 22, 20, 20, 20, 20, 20, 20, 20, 20, 20, 20, 20, 20, 20, 20, 20, 20, 77,
77, 77, 20, 20, 20, 20, 20, 20, 20, 20, 20, 20, 22, 20, 20, 20, 20, 20, 20, 20, 20, 20, 20, 20, 20, 20, 20, 22, 20, 20, 20, 20, 20, 24, 20, 20, 20, 20, 20, 20, 20, 22, 20, 20, 20, 22, 20, 20, 20, 77,
77, 77, 20, 20, 20, 22, 20, 20, 20, 20, 20, 20, 20, 20, 20, 22, 20, 20, 20, 20, 20, 20, 20, 20, 20, 20, 20, 20, 20, 20, 20, 20, 20, 20, 20, 20, 20, 20, 22, 20, 20, 22, 20, 20, 20, 20, 20, 20, 20, 77,
77, 77, 20, 22, 20, 20, 20, 20, 20, 20, 20, 20, 20, 22, 20, 20, 20, 20, 20, 20, 22, 20, 22, 20, 20, 20, 20, 20, 20, 20, 20, 20, 20, 22, 20, 20, 20, 20, 20, 20, 20, 20, 20, 20, 20, 20, 20, 20, 20, 77,
77, 77, 20, 20, 20, 20, 20, 20, 20, 20, 20, 20, 20, 20, 20, 20, 20, 20, 20, 22, 20, 20, 20, 20, 20, 22, 20, 20, 20, 20, 20, 20, 20, 20, 20, 20, 20, 20, 20, 20, 20, 20, 20, 20, 20, 20, 20, 20, 20, 77,
77, 77, 77, 77, 77, 77, 77, 77, 77, 77, 77, 77, 77, 77, 77, 77, 77, 77, 77, 77, 77, 77, 20, 20, 20, 20, 20, 20, 20, 20, 20, 20, 20, 20, 20, 77, 77, 77, 77, 77, 77, 77, 77, 77, 77, 77, 77, 77, 77, 77,
77, 77, 77, 77, 77, 77, 77, 77, 77, 77, 77, 77, 77, 77, 77, 77, 77, 77, 77, 77, 77, 77, 20, 20, 20, 20, 20, 20, 20, 20, 20, 20, 77, 77, 77, 77, 77, 77, 77, 77, 77, 77, 77, 77, 77, 77, 77, 77, 77, 77,
77, 77, 77, 77, 77, 77, 77, 77, 77, 77, 77, 77, 77, 77, 77, 77, 77, 77, 77, 77, 77, 77, 20, 20, 20, 20, 20, 22, 20, 20, 20, 77, 77, 77, 77, 0, 0, 0, 0, 0, 0, 0, 0, 0, 0, 0, 0, 0, 0, 77,
77, 77, 77, 77, 77, 77, 77, 77, 77, 77, 77, 77, 77, 77, 77, 77, 77, 77, 77, 77, 77, 77, 20, 20, 20, 20, 24, 20, 20, 20, 20, 77, 77, 77, 77, 20, 20, 20, 20, 20, 20, 20, 20, 20, 20, 62, 61, 0, 0, 77,
77, 77, 77, 77, 77, 77, 77, 77, 77, 77, 77, 77, 77, 77, 77, 77, 77, 77, 77, 77, 77, 77, 20, 20, 20, 20, 20, 20, 20, 20, 20, 77, 77, 77, 77, 20, 20, 20, 20, 20, 20, 20, 20, 20, 20, 0, 60, 0, 0, 77,
77, 77, 77, 77, 77, 77, 77, 77, 77, 77, 77, 77, 77, 77, 77, 77, 77, 77, 77, 77, 77, 77, 20, 20, 20, 20, 20, 20, 20, 20, 20, 77, 77, 77, 77, 77, 77, 77, 77, 77, 77, 77, 77, 24, 20, 0, 60, 0, 0, 77,
77, 77, 77, 77, 77, 77, 77, 77, 77, 77, 77, 77, 77, 77, 77, 77, 77, 77, 77, 77, 77, 77, 20, 20, 20, 20, 20, 20, 20, 20, 20, 77, 77, 77, 77, 77, 77, 77, 77, 77, 77, 77, 77, 20, 20, 0, 60, 0, 0, 77,
77, 77, 77, 77, 77, 77, 77, 77, 20, 20, 20, 20, 20, 20, 20, 20, 20, 20, 20, 20, 20, 24, 20, 20, 22, 20, 20, 20, 20, 20, 20, 77, 77, 77, 77, 77, 77, 77, 77, 77, 77, 77, 77, 20, 20, 0, 60, 0, 0, 77,
77, 77, 77, 77, 77, 77, 77, 77, 20, 20, 20, 20, 20, 20, 20, 20, 20, 20, 20, 20, 20, 20, 20, 20, 20, 20, 20, 20, 20, 20, 20, 77, 77, 77, 77, 77, 77, 77, 77, 77, 77, 77, 77, 20, 20, 0, 60, 0, 0, 77,
77, 77, 77, 77, 77, 77, 77, 77, 20, 20, 20, 20, 20, 20, 20, 20, 20, 20, 20, 20, 20, 20, 20, 20, 20, 20, 20, 20, 20, 20, 20, 20, 20, 20, 20, 20, 20, 20, 20, 20, 20, 20, 20, 20, 20, 0, 60, 0, 0, 77,
77, 77, 77, 77, 77, 77, 77, 77, 20, 20, 20, 20, 20, 20, 20, 20, 20, 20, 20, 22, 20, 20, 20, 20, 20, 20, 20, 20, 20, 20, 20, 20, 20, 20, 20, 22, 20, 20, 20, 20, 20, 22, 20, 20, 24, 0, 60, 0, 0, 77,
77, 77, 77, 77, 77, 77, 77, 77, 20, 20, 22, 20, 20, 20, 20, 20, 20, 20, 20, 20, 20, 20, 20, 20, 20, 20, 20, 22, 20, 20, 20, 20, 20, 20, 20, 20, 20, 20, 20, 20, 20, 20, 20, 20, 20, 0, 60, 0, 0, 77,
77, 77, 77, 77, 77, 77, 77, 77, 20, 20, 20, 20, 20, 20, 20, 20, 20, 20, 20, 20, 20, 20, 20, 20, 20, 20, 59, 0, 20, 20, 20, 20, 22, 20, 20, 20, 20, 20, 20, 20, 20, 20, 20, 20, 20, 20, 60, 20, 20, 77,
77, 77, 77, 77, 77, 77, 77, 77, 20, 20, 20, 20, 20, 20, 20, 20, 20, 20, 20, 20, 20, 22, 20, 20, 20, 20, 60, 0, 20, 20, 20, 20, 61, 62, 62, 62, 62, 62, 62, 62, 62, 62, 62, 62, 62, 62, 61, 20, 20, 77,
77, 77, 77, 77, 77, 77, 77, 20, 20, 20, 20, 20, 20, 20, 20, 20, 20, 20, 61, 62, 62, 62, 62, 20, 62, 62, 61, 62, 62, 62, 62, 62, 61, 20, 20, 20, 20, 20, 20, 20, 20, 20, 20, 22, 20, 20, 20, 20, 20, 77,
77, 77, 77, 77, 77, 77, 77, 77, 20, 20, 20, 20, 20, 20, 20, 20, 20, 62, 61, 20, 20, 20, 20, 20, 22, 20, 60, 20, 20, 20, 20, 20, 20, 20, 20, 77, 77, 77, 77, 77, 77, 77, 77, 77, 77, 77, 77, 77, 77, 77,
77, 20, 20, 20, 20, 20, 20, 20, 20, 20, 20, 20, 20, 20, 20, 20, 20, 20, 20, 20, 20, 20, 20, 20, 20, 20, 20, 20, 20, 20, 20, 20, 20, 20, 20, 77, 77, 77, 77, 77, 77, 77, 77, 77, 77, 77, 77, 77, 77, 77,
77, 20, 20, 20, 20, 20, 20, 20, 20, 20, 20, 20, 22, 20, 20, 20, 20, 20, 20, 22, 20, 20, 20, 20, 20, 20, 20, 20, 20, 20, 20, 20, 20, 20, 21, 77, 77, 77, 77, 77, 77, 77, 77, 77, 77, 77, 77, 77, 77, 77,
77, 20, 20, 20, 20, 20, 20, 20, 20, 20, 20, 20, 20, 20, 20, 20, 20, 20, 20, 20, 24, 20, 20, 20, 20, 20, 20, 20, 20, 20, 20, 20, 20, 20, 21, 77, 77, 77, 77, 77, 77, 77, 77, 77, 77, 77, 77, 77, 77, 77,
77, 20, 20, 20, 20, 20, 20, 22, 20, 20, 20, 20, 20, 20, 20, 20, 20, 20, 20, 20, 20, 20, 20, 20, 20, 22, 20, 20, 20, 20, 20, 20, 20, 20, 21, 77, 77, 77, 77, 77, 77, 77, 77, 77, 77, 77, 77, 77, 77, 77,
77, 20, 20, 20, 22, 20, 20, 20, 20, 20, 20, 20, 20, 20, 20, 20, 20, 20, 20, 20, 20, 20, 20, 20, 20, 20, 20, 20, 20, 20, 20, 20, 20, 20, 21, 77, 77, 77, 77, 77, 77, 77, 77, 77, 77, 77, 77, 77, 77, 77,
77, 20, 20, 20, 20, 20, 20, 20, 20, 20, 22, 20, 20, 20, 20, 20, 20, 20, 20, 20, 20, 20, 20, 20, 20, 20, 20, 20, 20, 20, 20, 20, 20, 20, 21, 77, 77, 77, 77, 77, 77, 77, 77, 77, 77, 77, 77, 77, 77, 77,
20, 20, 20, 20, 20, 20, 20, 20, 20, 20, 20, 20, 20, 20, 20, 20, 20, 20, 20, 20, 20, 20, 20, 20, 20, 20, 20, 20, 20, 20, 20, 20, 20, 20, 21, 77, 77, 77, 77, 77, 77, 77, 77, 77, 77, 77, 77, 77, 77, 77,
20, 20, 20, 20, 20, 20, 20, 20, 22, 20, 20, 22, 20, 20, 20, 20, 22, 20, 20, 20, 20, 20, 20, 20, 20, 22, 20, 20, 20, 20, 20, 20, 20, 20, 21, 77, 77, 77, 77, 77, 77, 77, 77, 77, 77, 77, 77, 77, 77, 77,
77, 20, 20, 20, 20, 20, 20, 20, 20, 20, 20, 20, 20, 20, 20, 20, 20, 20, 20, 20, 20, 20, 20, 20, 20, 20, 20, 20, 20, 20, 20, 20, 20, 20, 21, 77, 77, 77, 77, 77, 77, 77, 77, 77, 77, 77, 77, 77, 77, 77,
77, 20, 20, 20, 20, 20, 20, 20, 20, 20, 20, 20, 20, 20, 20, 20, 20, 20, 20, 20, 20, 20, 20, 20, 20, 20, 20, 20, 20, 22, 20, 20, 20, 20, 21, 77, 77, 77, 77, 77, 77, 77, 77, 77, 77, 77, 77, 77, 77, 77,
77, 20, 20, 20, 20, 20, 20, 20, 20, 20, 20, 22, 20, 20, 20, 20, 20, 20, 20, 20, 20, 20, 20, 20, 20, 20, 20, 20, 20, 20, 20, 20, 20, 20, 21, 77, 77, 77, 77, 77, 77, 77, 77, 77, 77, 77, 77, 20, 77, 77,
77, 20, 20, 20, 20, 20, 20, 20, 20, 20, 20, 20, 20, 20, 20, 20, 77, 20, 20, 20, 20, 20, 20, 77, 20, 20, 20, 20, 20, 20, 20, 20, 20, 21, 21, 21, 0, 0, 0, 0, 0, 0, 0, 0, 0, 0, 0, 0, 77, 77,
77, 77, 77, 77, 77, 77, 77, 77, 77, 77, 77, 77, 77, 77, 77, 77, 77, 20, 20, 20, 20, 20, 20, 77, 77, 77, 77, 77, 77, 77, 77, 77, 77, 77, 77, 77, 0, 20, 20, 20, 20, 20, 20, 20, 0, 0, 0, 0, 77, 77,
77, 77, 77, 77, 77, 0, 0, 0, 0, 0, 0, 0, 0, 0, 0, 0, 0, 0, 0, 59, 0, 0, 0, 0, 0, 0, 0, 0, 0, 0, 0, 0, 0, 0, 0, 0, 0, 20, 20, 20, 22, 20, 20, 20, 0, 0, 0, 0, 165, 77,
77, 77, 77, 77, 77, 20, 20, 20, 20, 20, 20, 20, 20, 20, 20, 20, 20, 20, 20, 20, 20, 20, 20, 20, 20, 20, 20, 20, 20, 20, 20, 20, 20, 20, 20, 20, 20, 20, 22, 20, 20, 20, 20, 20, 0, 0, 0, 0, 77, 77,
77, 77, 77, 77, 77, 22, 20, 20, 20, 20, 20, 20, 20, 22, 20, 20, 20, 20, 20, 20, 20, 20, 20, 20, 20, 20, 20, 20, 22, 20, 20, 20, 20, 20, 20, 20, 20, 20, 20, 20, 20, 20, 22, 20, 0, 0, 0, 0, 77, 77,
77, 77, 77, 77, 77, 20, 20, 20, 20, 20, 22, 20, 20, 20, 20, 20, 20, 20, 20, 20, 20, 20, 22, 20, 20, 20, 20, 20, 22, 20, 20, 22, 20, 20, 20, 20, 20, 20, 20, 20, 20, 20, 20, 20, 0, 0, 0, 0, 77, 77,
77, 77, 77, 77, 77, 20, 20, 20, 20, 20, 20, 20, 20, 20, 20, 22, 22, 20, 20, 22, 20, 20, 20, 20, 20, 20, 20, 20, 20, 20, 20, 20, 20, 20, 20, 20, 20, 20, 22, 20, 20, 20, 20, 20, 0, 0, 0, 0, 77, 77,
77, 77, 77, 77, 77, 20, 20, 20, 22, 20, 20, 20, 20, 20, 20, 20, 20, 20, 20, 20, 20, 20, 20, 20, 20, 20, 20, 20, 20, 20, 20, 20, 20, 20, 22, 20, 20, 20, 20, 20, 20, 20, 22, 20, 0, 0, 0, 0, 77, 77,
77, 77, 77, 77, 77, 77, 77, 77, 77, 77, 77, 77, 77, 77, 77, 77, 77, 77, 77, 77, 77, 77, 77, 77, 77, 77, 77, 77, 77, 77, 77, 77, 77, 77, 77, 77, 77, 77, 77, 77, 77, 77, 77, 77, 77, 77, 77, 77, 77, 77,
77, 77, 77, 77, 77, 77, 77, 77, 77, 77, 77, 77, 77, 77, 77, 77, 77, 77, 77, 77, 77, 77, 77, 77, 77, 77, 77, 77, 77, 77, 77, 77, 77, 77, 77, 77, 77, 77, 77, 77, 77, 77, 77, 77, 77, 77, 77, 77, 77, 77